1 1 1 1 1 1 1 1 1 1 3 3 3 3 3 3 3 3 3 4
6 0 0 0 0 0 0 0 0 0 0 0 0 0 0 0 0 0 0 4
6 0 0 0 0 0 0 0 0 0 0 0 0 0 0 0 0 0 0 4
6 0 0 0 4 4 4 0 0 0 0 3 2 2 2 0 0 0 0 4
6 0 0 0 0 0 4 0 0 0 0 3 0 0 0 0 0 6 0 4
6 0 0 0 0 0 4 4 4 0 0 0 0 0 0 0 0 6 0 4
6 0 0 3 0 0 0 0 0 0 0 0 0 0 1 1 1 6 0 4
6 0 0 0 0 0 0 0 0 0 6 0 0 0 0 0 0 0 0 4
6 0 0 0 0 0 0 0 0 0 0 0 4 0 0 0 0 6 0 4
6 0 0 4 4 4 0 4 4 0 0 0 4 0 0 0 0 6 0 4
6 0 0 4 0 0 0 0 0 0 0 0 0 0 0 0 0 0 0 4
6 0 0 0 0 0 0 0 0 0 0 0 0 0 0 0 0 0 0 4
6 2 2 2 2 2 2 2 2 1 1 1 1 1 1 1 1 1 1 1
